5.Ox
O..O.....
O..O.....
.........
.........
O........

